NO ./path
SO ./path
WE             ./path
EA ./path

F 200,100,0
C 2  25, 30, 0

    111111111111111
    100000100000001
100000100000001
100000  000000001
11111111 0011111
111111110011111
1111110 00000111
11100  0000000001
100000000000001
11111111    1111111

