C 200, 100, 0
F 225, 30, 0

SO ./path
NO ./path
EA ./path
WE ./path

111111111111111
100000100000001
100000100000001
100000000000001
111111110011111
111111110011111
111111000000111
111000000000001
100000000000001
111111111111111
0
