NO ./path
SO ./path
WE ./path
EA ./path

F200,100,0
F225,30,0

111111111111111
100000100000001
100000100000001
100000000000001
111111110011111
111111110011111
111111000000111
1110000S0000001
100000000000001
111111111111111

