NO ./path
SO ./path
NO ./path
EA ./path

F 200,100,0 
C 225,30,0

111111111111111
100000100000001
100000100000001
100000000000001
111111110011111
011111110011111
111111000000111
111000W00000001
100000000000001
111111111111111

