111111111111111
100000100000001
100000100000001
100000000000001
111111110011111
111111110011111
111111000000111
111000000000001
100000000000001
111111111111111

NO ./path
SO ./path
WE ./path
EA ./path

F 200, 100, 0
C 225, 30, 0

